###############
#@    #       #
# ### # ##### #
#   #   #   #e#
### ##### # # #
#     #   #   #
###############